Afghanistan(아프가니스탄) - 카불
Albania(알바니아) - 티라나
Algeria(알제리) - 알제
Andorra(안도라) - 안도라라베야
Angola(앙골라) - 루안다
Antigua and Barbuda(앤티가바부다) - 세인트존스
Argentina(아르헨티나) - 부에노스아이레스
Armenia(아르메니아) - 예레반
Australia(오스트레일리아) - 캔버라
Austria(오스트리아) - 빈
Azerbaijan(아제르바이잔) - 바쿠
Bahamas(바하마) - 나소
Bahrain(바레인) - 마나마
Bangladesh(방글라데시) - 다카
Barbados(바베이도스) - 브리지타운
Belarus(벨로루시) - 민스크
Belgium(벨기에) - 브뤼셀
Belize(벨리즈) - 벨모판
Benin(베냉) - 포르토노보
Bhutan(부탄) - 팀부
Bolivia(볼리비아) - 수크레
Bosnia and Herzegovina(보스니아 헤르체고비나) - 사라예보
Botswana(보츠와나) - 가보로네
Brazil(브라질) - 브라질리아
Brunei Darussalam(브루나이) - 반다르세리베가완
Bulgaria(불가리아) - 소피아
Burkina Faso(부르키나파소) - 와가두구
Burundi(부룬디) - 부줌부라
Cambodia(캄보디아) - 프놈펜
Cameroon(카메룬) - 야운데
Canada(캐나다) - 오타와
Cape Verde(카보베르데) - 프라이아
Central African Republic(중앙 아프리카 공화국) - 방기
Chad(차드) - 은자메나
Chile(칠레) - 산티아고
China(중국) - 베이징
Colombia(콜롬비아) - 보고타
Comoros(코모로) - 모로니
Congo (Republic of the) (콩고 공화국) - 브라자빌
Costa Rica(코스타리카) - 산호세
Côte d’Ivoire(코트디부아르) - 야무수크로
Croatia(크로아티아) - 자그레브
Cuba(쿠바) - 아바나
Cyprus(키프로스) - 니코시아
Czech Republic(체코) - 프라하
Democratic People’s Republic of Korea(북한) - 평양
Democratic Republic of the Congo(콩고 민주 공화국) - 킨샤샤
Denmark(덴마크) - 코펜하겐
Djibouti(지부티) - 지부티
Dominica(도미니카) - 로조
Dominican Republic(도미니카 공화국) - 산토도밍고
Ecuador(에콰도르) - 키토
Egypt(이집트) - 카이로
El Salvador(엘살바도르) - 산살바도르
Equatorial Guinea(적도 기니) - 말라보
Eritrea(에리트레아) - 아스마라
Estonia(에스토니아) - 탈린
Ethiopia(에티오피아) - 아디스아바바
Fiji(피지) - 수바
Finland(핀란드) - 헬싱키
France(프랑스) - 파리
Gabon(가봉) - 리브르빌
Gambia(감비아) - 반줄
Georgia(그루지야) - 트빌리시
Germany(독일) - 베를린
Ghana(가나) - 아크라
Greece(그리스) - 아테네
Grenada(그레나다) - 세인트조지스
Guatemala(과테말라) - 과테말라시티
Guinea(기니) - 코나크리
Guinea-Bissau(기니비사우) - 비사우
Guyana(가이아나) - 조지타운
Haiti(아이티) - 포르토프랭스
Honduras(온두라스) - 테구시갈파
Hungary(헝가리) - 부다페스트
Iceland(아이슬란드) - 레이캬비크
India(인도) - 뉴델리
Indonesia(인도네시아) - 자카르타
Iran(이란) - 테헤란
Iraq(이라크) - 바그다드
Ireland(아일랜드) - 더블린
Israel(이스라엘) - 예루살렘
Italy(이탈리아) - 로마
Jamaica(자메이카) - 킹스턴
Japan(일본) - 도쿄
Jordan(요르단) - 암만
Kazakhstan(카자흐스탄) - 아스타나
Kenya(케냐) - 나이로비
Kiribati(키리바시) - 타라와
Kuwait(쿠웨이트) - 쿠웨이트
Kyrgyzstan(키르기즈스탄) - 비슈케크
Lao People’s Democratic Republic(라오스) - 비엔티안
Latvia(라트비아) - 리가
Lebanon(레바논) - 베이루트
Lesotho(레소토) - 마세루
Liberia(라이베리아) - 몬로비아
Libya(리비아) - 트리폴리
Liechtenstein(리히텐슈타인) - 파두츠
Lithuania(리투아니아) - 빌뉴스
Luxembourg(룩셈부르크) - 룩셈부르크
Madagascar(마다가스카르) - 안타나나리보
Malawi(말라위) - 릴롱궤
Malaysia(말레이시아) - 쿠알라룸푸르
Maldives(몰디브) - 말레
Mali(말리) - 바마코
Malta(말타) - 발레타
Marshall Islands(마셜 제도) - 마유로
Mauritania(모리타니아) - 누악쇼트
Mauritius(모리셔스) - 포트루이스
Mexico(멕시코) - 멕시코시티
Micronesia (Federated States of) (미크로네시아) - 팔리키르
Monaco(모나코) - 모나코
Mongolia(몽골) - 울란바토르
Montenegro(몬테네그로) - 포드고리차
Morocco(모로코) - 라바트
Mozambique(모잠비크) - 마푸토
Myanmar(미얀마) - 네피도
Namibia(나미비아) - 빈트후크
Nauru(나우루) - 야렌
Nepal(네팔) - 카트만두
Netherlands(네덜란드) - 암스테르담
New Zealand(뉴질랜드) - 웰링턴
Nicaragua(니카라과) - 마나구아
Niger(니게르) - 니아메
Nigeria(나이지리아) - 아부자
Norway(노르웨이) - 오슬로
Oman(오만) - 무스카트
Pakistan(파키스탄) - 이슬라마바드
Palau(팔라우) - 코로르
Panama(파나마) - 파나마시티
Papua New Guinea(파푸아뉴기니) - 포트모르즈비
Paraguay(파라과이) - 아순시온
Peru(페루) - 리마
Philippines(필리핀) - 마닐라
Poland(폴란드) - 바르샤바
Portugal(포르투갈) - 리스본
Qatar(카타르) - 도하
Republic of Korea(대한민국)
Republic of Moldova(몰도바 공화국) - 키시네프
Romania(루마니아) - 부쿠레슈티
Russian Federation(러시아 연방) - 모스크바
Rwanda(르완다) - 키갈리
Saint Kitts and Nevis(세인트키츠네비스) - 바스테르
Saint Lucia(세인트루시아) - 캐스트리스
Saint Vincent and the Grenadines(세인트빈센트그레나딘) - 킹스타운
Samoa(사모아) - 아피아
San Marino(산마리노) - 산마리노
Sao Tome and Principe(상투메프린시페) - 상투메
Saudi Arabia(사우디아라비아) - 리야드
Senegal(세네갈) - 다카르
Serbia(세르비아) - 베오그라드
Seychelles(세이셸) - 빅토리아
Sierra Leone(시에라리온) - 프리타운
Singapore(싱가폴) - 싱가폴
Slovakia(슬로바키아) - 브라티슬라바
Slovenia(슬로베니아) - 류블랴나
Solomon Islands(솔로몬 제도) - 호니아라
Somalia(소말리아) - 모가디슈
South Africa(남아프리카 공화국) - 프리토리아
Spain(스페인) - 마드리드
Sri Lanka(스리랑카) - 콜롬보
Sudan(수단) - 카르툼
Suriname(수리남) - 파라마리보
Swaziland(스와질랜드) - 음바바네
Switzerland(스위스) - 베른
Sweden(스웨덴) - 스톡홀름
Syria(시리아) - 다마스쿠스
Tajikistan(타지키스탄) - 두샨베
Thailand(타이) - 방콕
The former Yugoslav Republic of Macedonia(마케도니아) - 스코페
Timor Leste(동티모르) - 딜리
Togo(토고) - 로메
Tonga(통가) - 누쿠알로파
Trinidad and Tobago(트리니다드토바고) - 포트오브스페인
Tunisia(튀니지) - 튀니스
Turkey(터키) - 앙카라
Turkmenistan(투르크메니스탄) - 아스하바트
Tuvalu(투발루) - 푸나푸티
Uganda(우간다) - 캄팔라
Ukraine(우크라이나) - 키예프
United Arab Emirates(아랍에미리트) - 아부다비
United Kingdom(영국) - 런던
United of Republic of Tanzania(탄자니아 공화국) - 도도마
United States(미국) - 워싱턴
Uruguay(우루과이) - 몬테비데오
Uzbekistan(우즈베키스탄) - 타슈켄트
Vanuatu(바누아투) - 빌라
Venezuela(베네주엘라) - 카라카스
Viet Nam(베트남) - 하노이
Yemen(예멘) - 사나
Zambia(잠비아) - 루사카
Zimbabwe(짐바브웨) - 하라레